###############################################
#...###.....######.............###......G...###
#.##....###.##.....###############.########.###
#S##.######.##.###...........#.......##.###.###
#....#......##.#############.#########........#
######.####.##.##.##.....###.###.....#.####.###
##.....#...###.......###.###.###.###.#.#.....##
##.#####.#.######.######.#######.#...###.###..#
##.......#...........#...........###.....####.#
###############################################